type octile
height 118
width 89
map
@@@@@@@@@@@@@@@@@@@@TTTTTTTTTTTTTTTTTTTTT@@@@@@@@@@@@@@@@@@@@@@@@@@@@@@@@@@@@@@@@@@@@@@@@
@@@@@@@@@@@@@@@@@@@@TTTTTTTTTTTTTTTTTTTTT@@@@@@@@@@@@@@TTTTTTTTTTTTTT@@@@@@@@@@@@@@@@@@@@
@@@@@@@@@@@@@@@@@@@@TTsTTT.....TTT..TTTTT@@@@@@@@@@@@@@TTTTTTTTTTTTTT@@@@@@@@@@@@@@@@@@@@
@@@@@@@@@@@@@@@@@@@@TT.TTT.....TTT..TTTTT@@@@@@@@@@@@@@TTTTT.TTT.TTTT@@@@@@@@@@@@@@@@@@@@
@@@@@@@@@@@@@@@@@@@@TT.TTT.....TTT..TTTTTT@@@@@@@@@@@@@TTTTT.TTT.TTTT@@@@@@@@@@@@@@@@@@@@
@@@@@@@@@@@@@@@@@@@@TT.TTT.....TTT...TTTTTTTTTTTTTTTTTTTTTTT.TTT.TTTT@@@@@@@@@@@@@@@@@@@@
@@@@@@@@@@@@@@@@@@@@TT.TTT.....TTT.....TTTTTTTTTTTTTTTTTTTTT.TTT.TTTT@@@@@@@@@@@@@@@@@@@@
@@@@@@@@@@@@@@@@@@@@TT.TTT.....TTT.............TTT.......TTT.....TTTT@@@@@@@@@@@@@@@@@@@@
@@@@@@@@@@@@@@@@@@@@TT.TTT.....TTT...............................TTTT@@@@@@@@@@@@@@@@@@@@
@@@@@@@@@@@@@@@@@@@@TT............................................TTT@@@@@@@@@@@@@@@@@@@@
@@@@@@@@@@@@@@@@@@@@TT............................................TTT@@@@@@@@@@@@@@@@@@@@
@@@@@@@@@@@@@@@@@@@@TT............................................TTT@@@@@@@@@@@@@@@@@@@@
@@@@@@@@@@@@@@@@@@@@TT............................................TTT@@@@@@@@@@@@@@@@@@@@
@@@@@@@@@@@@@@@@@@@@TT............................................TTT@@@@@@@@@@@@@@@@@@@@
@@@@@@@@@@@@@@@@@@@@TTTT....TTTTT......TTT........................TTT@@@@@@@@@@@@@@@@@@@@
@@@@@@@@@@@@@@@@@@@@TTTTTTT.TTTTT.TTT..TTT........................TTT@@@@@@@@@@@@@@@@@@@@
@@@@@@@@@@@@@@@@@@@@TTTTTTT.TTTTTTTTT..TTT.........................TTT@@@@@@@@@@@@@@@@@@@
@@@@@@@@@@@@@@@@@@@@TTTTTTT.TTTTTTTTT..TTT.........................TTT@@@@@@@@@@@@@@@@@@@
@@@@@@@@@@@@@@@@@@@@TTTTTTT.TTTTTTTTT..TTT.............TTT.........TTT@@@@@@@@@@@@@@@@@@@
@@@@@@@@@@@@@@@@@@@@TTTTTTT.TTTTT@TTT..TTT..........TTTTTTTTTTTTTT.TT@@@@@@@@@@@@@@@@@@@@
@@@@@@@@@@@@@@@@@@@@TTTTTTTTTTTTTTTTTTTTTTTTTTTT..TTTTTTTTTTTTTTTTTTT@@@@@@@@@@@@@@@@@@@@
@@@@@@@@@@@@@@@@@@@@TTTTTTTTTTTTTTTTTTTTTTTTTTTT..TTTTTTT@@@@@@TTTTTT@@@@@@@@@@@@@@@@@@@@
@@@@@@@@@@@@@@@@@@@@@@@@@@@@@@@@@@@@@@@@TTTTT.......T..TT@@@@@@@@@@@@@@@@@@@@@@@@@@@@@@@@
@@@@@@@@@@@@@@@@@@@@@@@@@@@@@@@@@@@@@@@@@T.............TT@@@@@@@@@@@@@@@@@@@@@@@@@@@@@@@@
@@@@@@@@@@@@@@@@@@@@@@@@@@@@@@@@@@@@@@@@@T.............TT@@@@@@@@@@@@@@@@@@@@@@@@@@@@@@@@
@@@@@@@@@@@@@@@@@@@@@@@@@@@@@@@@@@@@@@@@@T.............TT@@@@@@@@@@@@@@@@@@@@@@@@@@@@@@@@
@@@@@@@@@@@@@@@@@@@@@@@@@@@@@@@@@@@@@@@@@T.............TT@@@@@@@@@@@@@@@@@@@@@@@@@@@@@@@@
@@@@@@@@@@@@@@@@@@@@@@@@@@@@@@@@@@@@@@@@@T.............TT@@@@@@@@@@@@@@@@@@@@@@@@@@@@@@@@
@@@@@@@@@@@@@@@@@@@@@@@@@@@@@@@@@@@@@@@@TT.............TTT@@@@@@@@@@@@@@@@@@@@@@@@@@@@@@@
@@@@@@@@@@@@@@@@@@@@@@@@@TTTTTTTTTTTTTTTTT.............TTTTTTTTTTTTTTTTTTTTTTTTTTTTTTTTTT
@@@@@@@@@@@@@@@@@@@@@@@@@TTTTTTTTTTTTTTTTT...............TTTTTTTTTTTTTTTTTTTTTTTTTTTTTTTT
@@@@@@@@@@@@@@@@@@@@@@@@@TTTTTTTTTTTTTTT................TTTTTTTT.TT.TTTTTTTTTTTTTTTTTTTTT
@@@@@@@@@@@@@@@@@@@@@@@@@TT..TTTTTTTTTTT................TTTTTTTT.TT.TTTTT....TTTTTTTTTTTT
@@@@@@@@@@@@@@@@@@@@@@@@@TT........TTTTT................TTTTTTTT.TT.TTTTT....TTTTT...TTTT
@@@@@@@@@@@@@@@@@@@@@@@@@TT..........TTT................TTTTTTTT.TT.TTTTT....TTTTT...TTTT
@@@@@@@@@@@@@@@@@@@@@@@@@TT..........TTT...................TTTTT....TTTTT....TTTTT...TTTT
@@@@@@@@@@@@@@@@@@@@@@@@@TT..........TTT.............................................TTTT
@@@@@@@@@@@@@@@@@@@@@@@@@TT..........TTT.........................T...................TTTT
@@@@@@@@@@@@@@@@@@@@@@@@@T...........TTT........................TT....TT........TT.....TT
@@@@@@@@@@@@@@@@@@@@@@@@@T...........TTT.......................TTT....TTTT.....TTT.....TT
@@@@@@@@@@@@@@@@@@@@@@@@@T...........TTT.......................TTT.....TTTT....TTTT....TT
@@@@@@@@@@@@@@@@@@@@@@@@@T...........TTT........................T.......TTT.....TTT....TT
@@@@@@@@@@@@@@@@@@@@@@@@@T...........TTT...............................................TT
@@@@@@@@@@@@@@@@@@@@@@@@@T...........TTT...............................................TT
@@@@@@@@@@@@@@@@@@@@@@@@@TT..........TTT.................................................
@@@@@@@@@@@@@@@@@@@@@@@@@TT..........TTT.................................................
@@@@@@@@@@@@@@@@@@@@@@@@@TT..........TTT.................................................
@@@@@@@@@@@@@@@@@@@@@@@@@TT..........TTT...............................................TT
@@@@@@@@@@@@@@@@@@@@@@@@@TT..........TTT...............................................TT
@@@@@@@@@@@@@@@@@@@@@@@@@TT..........TTT......................................T........TT
@@@@@@@@@@@@@@@@@@@@@@@@@TT....TTTTTTTTT...................................TTTT........TT
@@@@@@@@@@@@@@@@@@@@@@@@@TT....TTTTTTTTT...................................TTTT........TT
@@@@@@@@@@@@@@@@@@@@@@@@@TT....TTTTTTTTT...............TTT..........TT......TTT...TTTTTTT
@@@@@@@@@@@@@@@@@TT...TTTTT............................TTT.TT.......TTT...........TTTTTTT
@@@@@@@@@@@@@@@@@TT...TTTT.............................TTTTTT.......TTTT..........TTTT@TT
@@@@@@@@@@@@@@@@@T.....................................TTTTTT.......TTTTT.........TTTT@TT
@@@@@@@@@@@@@@@@@T.................................TTTTTTTTTT.......T.TTT.......TTT@@@@TT
@@@@@@@@@@@@@@@@@T................................TTTTTTTT............TTTTTTTTTTTTT@@@@TT
@@@@@@@@@@@@@@@@@T.................................TTTTTTT............TTT@@@@@@@TTT@@@@TT
@@@@@@@@@@@@@@@@@T..............................T.TTTTTTTT.............TT@@@@@@@TTT@@@TTT
@@@@@@@@@@@@@@@@@TT............................TTTTTTTTTTT..TTTTTTTTT..TT@@@@@@@TTT@@@TTT
TTTTTTTTTTTTTTTTTTT....................TTT.....TTTTTTTTTTTTTTTTTTTTTTTTTT@@@@@@@TTTTTTTTT
TTTTTTTTTTTTTTTTTTT..TTTTTTT...TTTTT...TTT.....TTT@@@@@@@@@@@@@@@@@@@@@@@@@@@@@@@@@@@@@@@
TTTTTTTTTTTTTTTTTT...TTTTTTT...TTTTT...TTT.....TT@@@@@@@@@@@@@@@@@@@@@@@@@@@@@@@@@@@@@@@@
TT..TTTTTTTT...TTTTTTTTTTTTTTTTTTTTTTTTTTT.....TT@@@@@@@@@@@@@@@@@@@@@@@@@@@@@@@@@@@@@@@@
TT..TTTTTTTT...TTTTTTTTTTTTTTTTTTTTTTTTTTT.....TT@@@@@@@@@@@@@@@@@@@@@@@@@@@@@@@@@@@@@@@@
TT..TTTTTTTT...TTTTTTTTTTTTTTTTTTTTTTTTTTT.....TT@@@@@@@@@@@@@@@@@@@@@@@@@@@@@@@@@@@@@@@@
TT..TTTTTTTT...TTTTTTTTTTTTTTTTTTTTTTTTTTT.....TT@@@@@@@@@@@@@@@@@@@@@@@@@@@@@@@@@@@@@@@@
TT..TTTTTTTT..TTTTTTTTTTTTTTTTTTTTTTTTTTTT.....TT@@@@@@@@@@@@@@@@@@@@@@@@@@@@@@@@@@@@@@@@
TT............TTTTTTTTTTTTTTTTTTTTTTTTTTTT.....TT@@@@@@@@@@@@@@@@@@@@@@@@@@@@@@@@@@@@@@@@
TT............TTTTTTTTTTTTTTTTTTTTTTTTTTTT.....TT@@@@@@@@@@@@@@@@@@@@@@@@@@@@@@@@@@@@@@@@
TT.....................TTT.....TTTTTTTTTTT.....TT@@@@@@@@@@@@@@@@@@@@@@@@@@@@@@@@@@@@@@@@
TT.............................TTTTTTTTTTT.....TT@@@@@@@@@@@@@@@@@@@@@@@@@@@@@@@@@@@@@@@@
TT...............................TTTTTTTTT.....TT@@@@@@@@@@@@@@@@@@@@@@@@@@@@@@@@@@@@@@@@
TT...............................TTTTTTTTT.....TT@@@@@@@@@@@@@@@@@@@@@@@@@@@@@@@@@@@@@@@@
TT.....................TTT.......TTTTTTTTT.....TT@@@@@@@@@@@@@@@@@@@@@@@@@@@@@@@@@@@@@@@@
TT......TTT.....TTTTTTTTTT...........TTTTT.....TT@@@@@@@@@@@@@@@@@@@@@@@@@@@@@@@@@@@@@@@@
TT......TTT......TTTTTTTTT...........TTTTT.....TT@@@@@@@@@@@@@@@@@@@@@@@@@@@@@@@@@@@@@@@@
TTT.....TTT......T.....TTT.............TTT.....TT@@@@@@@@@@@@@@@@@@@@@@@@@@@@@@@@@@@@@@@@
TTT.TTT.TTT......T.....TTT.............TTT.....TT@@@@@@@@@@@@@@@@@@@@@@@@@@@@@@@@@@@@@@@@
TTT.TTT.TTT............TTT...TTT...............TT@@@@@@@@@@@@@@@@@@@@@@@@@@@@@@@@@@@@@@@@
TTT.TTT.TTT............TTT...TTTT..............TT@@@@@@@@@@@@@@@@@@@@@@@@@@@@@@@@@@@@@@@@
TTT.TTT.TTT.....TT.....TTT..TTTTT..............TT@@@@@@@@@@@@@@@@@@@@@@@@@@@@@@@@@@@@@@@@
TTT....TTT@TTT.TTT.....TTT..TTTTT......TTT.....TT@@@@@@@@@@@@@@@@@@@@@@@@@@@@@@@@@@@@@@@@
TTTTTTTTTTTTTTTTTTTTTTTTTTTTTTTTTTTTTTTTTTT....TT@@@@@@@@@@@@@@@@@@@@@@@@@@@@@@@@@@@@@@@@
TTTTTTTTTTTTTTTTTTTTTTTTTTTTTTTTTTTTTTTTTTTT...TT@@@@@@@@@@@@@@@@@@@@@@@@@@@@@@@@@@@@@@@@
@@@@@@@@@@@@@@@@@@@@@@@@@@@@@@@@@@@@@@@@TTT....TT@@@@@@@@@@@@@@@@@@@@@@@@@@@@@@@@@@@@@@@@
@@@@@@@@@@@@@@@@@@@@@@@@@@@@@@@@@@@@@@@@TT.....TT@@@@@@@@@@@@@@@@@@@@@@@@@@@@@@@@@@@@@@@@
@@@@@@@@@@@@@@@@@@@@@@@@@@@@@@@@@@@@@@@@TT.....TT@@@@@@@@@@@@@@@@@@@@@@@@@@@@@@@@@@@@@@@@
@@@@@@@@@@@@@@@@@@@@@@@@@@@@@@@@@@@@@@@@TT.....TT@@@@@@@@@@@@@@@@@@@@@@@@@@@@@@@@@@@@@@@@
@@@@@@@@@@@@@@@@@@@@@@@@@@@@@@@@@@@@@@@@TT.....TT@@@@@@@@@@@@@@@@@@@@@@@@@@@@@@@@@@@@@@@@
@@@@@@@@@@@@@@@@@@@@@@@@@@@@@@@@@@@@@@@@TT.....TT@@@@@@@@@@@@@@@@@@@@@@@@@@@@@@@@@@@@@@@@
@@@@@@@@@@@@@@@@@@@@@@@@@@@@@@@@@@@@@@@@TT.....TT@@@@@@@@@@@@@@@@@@@@@@@@@@@@@@@@@@@@@@@@
TTTTTTTTTTTTTTTTTTTTTTTTTTTTTTTTTTTTTTTTTT.....TT@@@@@@@@@@@@@@@@@@@@@@@@@@@@@@@@@@@@@@@@
TT.....................TTT........TTTT.TTT.....TT@@@@@@@@@@@@@@@@@@@@@@@@@@@@@@@@@@@@@@@@
TTTTTTTT...............TTT........TTTT.TTT.....TT@@@@@@@@@@@@@@@@@@@@@@@@@@@@@@@@@@@@@@@@
TTTTTTTT...............................TTT.....TT@@@@@@@@@@@@@@@@@@@@@@@@@@@@@@@@@@@@@@@@
TTTTTTTT...............................TTT.....TT@@@@@@@@@@@@@@@@@@@@@@@@@@@@@@@@@@@@@@@@
TTTTTTTT...............TTT.............TTT.....TT@@@@@@@@@@@@@@@@@@@@@@@@@@@@@@@@@@@@@@@@
TTTTTTTT...............TTT.............TTT.....TT@@@@@@@@@@@@@@@@@@@@@@@@@@@@@@@@@@@@@@@@
TTTTTTTT.........TTTTTTTTTTT...........TTT.....TT@@@@@@@@@@@@@@@@@@@@@@@@@@@@@@@@@@@@@@@@
TTTTTTTT.........TTTTTTTTTTT...........TTT.....TT@@@@@@@@@@@@@@@@@@@@@@@@@@@@@@@@@@@@@@@@
TTTTTTTT.........TTTTTTTTTTT...........TTT.....TT@@@@@@@@@@@@@@@@@@@@@@@@@@@@@@@@@@@@@@@@
TTTTTTTT..........TTTTTTTTTTTTTT.......TTT.....TT@@@@@@@@@@@@@@@@@@@@@@@@@@@@@@@@@@@@@@@@
TTTT..............TTTTTTTTTTTTTT...............TT@@@@@@@@@@@@@@@@@@@@@@@@@@@@@@@@@@@@@@@@
TTT...............TTTTTTTTTT...................TT@@@@@@@@@@@@@@@@@@@@@@@@@@@@@@@@@@@@@@@@
TT.....................TTTTTTTTTTT.....TTT....TTT@@@@@@@@@@@@@@@@@@@@@@@@@@@@@@@@@@@@@@@@
TT.....................TTT@TTTTTTT.....TTT....TTT@@@@@@@@@@@@@@@@@@@@@@@@@@@@@@@@@@@@@@@@
TT.............TTTTTTTTTTTTTTTTTTTTTTTTTTTTTTTTTT@@@@@@@@@@@@@@@@@@@@@@@@@@@@@@@@@@@@@@@@
TTTTTT.TT......TTTTTTTTTTTTTTTTTTTTTTTTTTTTTTTTTT@@@@@@@@@@@@@@@@@@@@@@@@@@@@@@@@@@@@@@@@
TT@@@@TTT......TTT@@@@@@@@@@@@@@@@@@@@@@@@@@@@@@@@@@@@@@@@@@@@@@@@@@@@@@@@@@@@@@@@@@@@@@@
TT@@@@TT......TTT@@@@@@@@@@@@@@@@@@@@@@@@@@@@@@@@@@@@@@@@@@@@@@@@@@@@@@@@@@@@@@@@@@@@@@@@
TT@@@@@@T.....TTT@@@@@@@@@@@@@@@@@@@@@@@@@@@@@@@@@@@@@@@@@@@@@@@@@@@@@@@@@@@@@@@@@@@@@@@@
TT@@@@@@T.....TTT@@@@@@@@@@@@@@@@@@@@@@@@@@@@@@@@@@@@@@@@@@@@@@@@@@@@@@@@@@@@@@@@@@@@@@@@
TT@@@@TTT......TT@@@@@@@@@@@@@@@@@@@@@@@@@@@@@@@@@@@@@@@@@@@@@@@@@@@@@@@@@@@@@@@@@@@@@@@@
TT@@@@TtT......TT@@@@@@@@@@@@@@@@@@@@@@@@@@@@@@@@@@@@@@@@@@@@@@@@@@@@@@@@@@@@@@@@@@@@@@@@
TTTTTTT.......TTT@@@@@@@@@@@@@@@@@@@@@@@@@@@@@@@@@@@@@@@@@@@@@@@@@@@@@@@@@@@@@@@@@@@@@@@@
TTTTTTTTTTTTTTTTT@@@@@@@@@@@@@@@@@@@@@@@@@@@@@@@@@@@@@@@@@@@@@@@@@@@@@@@@@@@@@@@@@@@@@@@@
